...$.....#.*...
.........#.**..
.**....$.#....$
....*....#....$
.... ....#.....
.........#.....
.........#.....
..M......#.....
   .*....#.....
.........#.....
...*..$.*#.*...