M...**.#....*..
....$..#.....$.
*......#.......
.......#.......
###############
.....$.#.......
...*...#..*..*.
..*....#.*.....
.......#....$..
...$...#..$....
.......#.......