..#........#...
.*.#*.$...#....
....#....#.....
....$#..#$.....
M.....##..**...
..*..$##.......
.....#..#...$..
....#.*..#.....
...#......#....
..#....$...#...
.#........D.#..